########################################
#                                      #
#                                      #
#                                      #
####################################   #
#                                      #
#                                      #
#                                      #
#   ####################################
#                                      #
#                                      #
#                                      #
####################################   #
#                                      #
#                                      #
#                                      #
#   ####################################
#                                      #
#                                      #
#                                      #
####################################   #
#                                      #
#                                      #
#                                      #
#   ####################################
#                                      #
#                                      #
#                                      #
####################################   #
#                                      #
#                                      #
#                                      #
########################################
