[###][###][###][###][###][###][###][###][###][###][###][###][###][###][###][###][###][###][###]
[###][   ][   ][   ][   ][   ][   ][   ][   ][   ][   ][   ][   ][   ][   ][   ][   ][   ][###]
[###][   ][001][   ][   ][   ][   ][   ][   ][   ][   ][   ][   ][   ][   ][   ][   ][   ][###]
[###][   ][   ][   ][   ][   ][   ][   ][   ][   ][   ][   ][   ][   ][   ][   ][   ][   ][###]
[###][###][###][###][###][###][###][###][###][###][###][###][###][###][###][   ][   ][   ][###]
[###][   ][   ][   ][   ][   ][   ][   ][   ][   ][   ][   ][   ][   ][   ][   ][   ][   ][###]
[###][   ][   ][   ][   ][   ][   ][   ][   ][   ][   ][   ][   ][   ][   ][   ][   ][   ][###]
[###][   ][   ][   ][   ][   ][   ][   ][   ][   ][   ][   ][   ][   ][   ][   ][   ][   ][###]
[###][   ][   ][   ][###][###][###][###][###][###][###][###][###][###][###][###][###][###][###]
[###][   ][   ][   ][   ][   ][   ][   ][   ][   ][   ][   ][   ][   ][   ][   ][   ][   ][###]
[###][   ][   ][   ][   ][   ][   ][   ][   ][   ][   ][   ][   ][   ][   ][   ][   ][   ][###]
[###][   ][   ][   ][   ][   ][   ][   ][   ][   ][   ][   ][   ][   ][   ][   ][   ][   ][###]
[###][###][###][###][###][###][###][###][###][###][###][###][###][###][###][   ][   ][   ][###]
[###][   ][   ][   ][   ][   ][   ][   ][   ][   ][   ][   ][   ][   ][   ][   ][   ][   ][###]
[###][   ][   ][   ][   ][   ][   ][   ][   ][   ][   ][   ][   ][   ][   ][   ][   ][   ][###]
[###][   ][   ][   ][   ][   ][   ][   ][   ][   ][   ][   ][   ][   ][   ][   ][   ][   ][###]
[###][   ][   ][   ][###][###][###][###][###][###][###][###][###][###][###][###][###][###][###]
[###][   ][   ][   ][   ][   ][   ][   ][   ][   ][   ][   ][   ][   ][   ][   ][   ][   ][###]
[###][   ][   ][   ][   ][   ][   ][   ][   ][   ][   ][   ][   ][   ][   ][   ][   ][   ][###]
[###][   ][   ][   ][   ][   ][   ][   ][   ][   ][   ][   ][   ][   ][   ][   ][   ][   ][###]
[###][###][###][###][###][###][###][###][###][###][###][###][###][###][###][###][###][###][###]