[###][###][###][###][###][###][###][###][###][###][###][###][###][###][###][###][###][###][###]
[###][   ][   ][   ][   ][   ][   ][   ][   ][   ][   ][   ][   ][   ][   ][   ][   ][   ][###]
[###][   ][001][   ][   ][   ][   ][   ][   ][   ][   ][   ][   ][   ][   ][   ][   ][   ][###]
[###][   ][   ][   ][   ][   ][   ][   ][   ][   ][   ][   ][   ][   ][   ][   ][   ][   ][###]
[###][###][###][###][###][###][###][###][###][###][###][###][###][###][###][   ][   ][   ][###]
[###][   ][   ][   ][   ][   ][   ][   ][   ][   ][   ][   ][   ][   ][   ][   ][   ][   ][###]
[###][   ][   ][   ][   ][   ][   ][   ][   ][   ][   ][   ][   ][   ][   ][   ][002][   ][###]
[###][   ][   ][   ][   ][   ][   ][   ][   ][   ][   ][   ][   ][   ][   ][   ][   ][   ][###]
[###][   ][   ][   ][###][###][###][###][###][###][###][###][###][###][###][###][###][###][###]
[###][   ][   ][   ][   ][   ][   ][   ][   ][   ][   ][   ][   ][   ][   ][   ][   ][   ][###]
[###][   ][003][   ][   ][   ][   ][   ][   ][   ][   ][   ][   ][   ][   ][   ][   ][   ][###]
[###][   ][   ][   ][   ][   ][   ][   ][   ][   ][   ][   ][   ][   ][   ][   ][   ][   ][###]
[###][###][###][###][###][###][###][###][###][###][###][###][###][###][###][   ][   ][   ][###]
[###][   ][   ][   ][   ][   ][   ][   ][   ][   ][   ][   ][   ][   ][   ][   ][   ][   ][###]
[###][   ][004][   ][   ][   ][   ][   ][   ][   ][   ][   ][   ][   ][   ][   ][   ][   ][###]
[###][   ][   ][   ][   ][   ][   ][   ][   ][   ][   ][   ][   ][   ][   ][   ][   ][   ][###]
[###][   ][   ][   ][###][###][###][###][###][###][###][###][###][###][###][###][###][###][###]
[###][   ][   ][   ][   ][   ][   ][   ][   ][   ][   ][   ][   ][   ][   ][   ][   ][   ][###]
[###][   ][   ][   ][   ][   ][   ][   ][   ][   ][   ][   ][   ][   ][   ][   ][005][   ][###]
[###][   ][   ][   ][   ][   ][   ][   ][   ][   ][   ][   ][   ][   ][   ][   ][   ][   ][###]
[###][###][###][###][###][###][###][###][###][###][###][###][###][###][###][###][###][###][###]